0  ,0  ,0  ,0  ,0  ,0  ,0  ,0  ,0  ,0  ,0  ,0  ,0  ,0  ,0  ,0  ,0  ,0  ,0  ,0  ,0  ,0  ,0  ,0  ,0  ,0  ,0  ,0  ,0  ,0  ,0  ,0  ,0  ,0  ,0  ,0  ,0  ,0  ,0  ,0  ,0  ,0  ,0  ,0  ,0  ,0  ,0  ,0  ,0  ,0  ,0  ,0  ,0  ,0  ,0  
0  ,0  ,0  ,0  ,0  ,0  ,0  ,0  ,0  ,0  ,0  ,0  ,0  ,0  ,0  ,0  ,0  ,0  ,0  ,0  ,0  ,0  ,0  ,0  ,0  ,0  ,0  ,0  ,0  ,0  ,0  ,0  ,0  ,0  ,0  ,0  ,0  ,0  ,0  ,0  ,0  ,0  ,0  ,0  ,0  ,0  ,0  ,0  ,0  ,0  ,0  ,0  ,0  ,0  ,0  
0  ,0  ,0  ,0  ,0  ,0  ,0  ,0  ,0  ,0  ,0  ,0  ,0  ,0  ,0  ,0  ,0  ,0  ,0  ,0  ,0  ,0  ,0  ,0  ,0  ,0  ,0  ,0  ,0  ,0  ,0  ,0  ,0  ,0  ,0  ,0  ,0  ,0  ,0  ,0  ,0  ,0  ,0  ,0  ,0  ,0  ,0  ,0  ,0  ,0  ,0  ,0  ,0  ,0  ,0  
0  ,0  ,0  ,0  ,0  ,0  ,0  ,0  ,0  ,0  ,0  ,0  ,0  ,0  ,0  ,0  ,0  ,0  ,0  ,0  ,0  ,0  ,0  ,0  ,0  ,0  ,0  ,0  ,0  ,0  ,0  ,0  ,0  ,0  ,0  ,0  ,0  ,0  ,0  ,0  ,0  ,0  ,0  ,0  ,0  ,0  ,0  ,0  ,0  ,0  ,0  ,0  ,0  ,0  ,0  
0  ,0  ,0  ,0  ,2  ,2  ,2  ,2  ,0  ,0  ,0  ,0  ,0  ,0  ,0  ,0  ,0  ,0  ,0  ,0  ,0  ,0  ,0  ,0  ,0  ,0  ,0  ,0  ,0  ,0  ,0  ,0  ,0  ,0  ,0  ,0  ,0  ,0  ,0  ,0  ,0  ,0  ,0  ,0  ,0  ,0  ,0  ,0  ,0  ,0  ,0  ,0  ,0  ,0  ,0  
0  ,0  ,0  ,0  ,0  ,0  ,0  ,2  ,0  ,0  ,0  ,0  ,0  ,0  ,0  ,0  ,0  ,0  ,0  ,0  ,0  ,0  ,0  ,0  ,0  ,0  ,0  ,0  ,0  ,0  ,0  ,0  ,0  ,0  ,0  ,0  ,0  ,0  ,0  ,0  ,0  ,0  ,0  ,0  ,0  ,0  ,0  ,0  ,0  ,0  ,0  ,0  ,0  ,0  ,0  
0  ,0  ,0  ,0  ,0  ,0  ,0  ,2  ,0  ,0  ,0  ,0  ,0  ,0  ,0  ,0  ,0  ,0  ,0  ,0  ,0  ,0  ,0  ,0  ,0  ,0  ,0  ,0  ,0  ,0  ,0  ,0  ,0  ,0  ,0  ,0  ,0  ,0  ,0  ,0  ,0  ,0  ,0  ,0  ,0  ,0  ,0  ,0  ,0  ,0  ,0  ,0  ,0  ,0  ,0  
0  ,0  ,0  ,0  ,0  ,0  ,0  ,2  ,0  ,0  ,0  ,0  ,0  ,0  ,0  ,0  ,0  ,0  ,0  ,0  ,0  ,0  ,0  ,0  ,0  ,0  ,0  ,0  ,0  ,0  ,0  ,0  ,0  ,0  ,0  ,0  ,0  ,0  ,0  ,0  ,0  ,0  ,0  ,0  ,0  ,0  ,0  ,0  ,0  ,0  ,0  ,0  ,0  ,0  ,0  
0  ,0  ,0  ,0  ,0  ,0  ,0  ,2  ,0  ,0  ,0  ,0  ,2  ,0  ,0  ,0  ,0  ,0  ,0  ,0  ,0  ,2  ,0  ,0  ,0  ,0  ,0  ,0  ,2  ,0  ,0  ,0  ,0  ,0  ,0  ,0  ,0  ,0  ,0  ,0  ,0  ,0  ,0  ,0  ,0  ,0  ,0  ,0  ,0  ,0  ,0  ,0  ,0  ,0  ,0  
0  ,0  ,0  ,0  ,0  ,0  ,0  ,2  ,0  ,0  ,0  ,0  ,2  ,0  ,0  ,0  ,0  ,0  ,0  ,0  ,0  ,2  ,0  ,0  ,0  ,0  ,0  ,0  ,2  ,0  ,0  ,0  ,0  ,0  ,0  ,0  ,0  ,0  ,0  ,0  ,0  ,0  ,0  ,0  ,0  ,0  ,0  ,0  ,0  ,0  ,0  ,0  ,0  ,0  ,0  
0  ,0  ,0  ,0  ,0  ,0  ,0  ,2  ,2  ,2  ,2  ,2  ,2  ,2  ,2  ,2  ,2  ,2  ,2  ,2  ,2  ,2  ,2  ,2  ,2  ,2  ,2  ,2  ,2  ,2  ,2  ,2  ,2  ,2  ,2  ,2  ,0  ,0  ,0  ,0  ,0  ,0  ,0  ,0  ,0  ,0  ,0  ,0  ,0  ,0  ,0  ,0  ,0  ,0  ,0  
0  ,0  ,0  ,0  ,0  ,0  ,0  ,0  ,0  ,0  ,0  ,0  ,0  ,0  ,0  ,0  ,0  ,0  ,0  ,0  ,0  ,0  ,0  ,0  ,0  ,0  ,0  ,0  ,0  ,0  ,0  ,0  ,0  ,0  ,0  ,2  ,0  ,0  ,0  ,0  ,0  ,0  ,0  ,0  ,0  ,0  ,0  ,0  ,0  ,0  ,0  ,0  ,0  ,0  ,0  
0  ,0  ,0  ,0  ,0  ,0  ,0  ,0  ,0  ,0  ,0  ,0  ,0  ,0  ,0  ,0  ,0  ,0  ,0  ,0  ,0  ,0  ,0  ,0  ,0  ,0  ,0  ,0  ,0  ,0  ,0  ,0  ,0  ,0  ,0  ,2  ,0  ,0  ,0  ,2  ,0  ,0  ,0  ,0  ,0  ,0  ,0  ,0  ,0  ,0  ,0  ,0  ,0  ,0  ,0  
0  ,0  ,0  ,0  ,0  ,0  ,0  ,0  ,0  ,0  ,0  ,0  ,0  ,0  ,0  ,0  ,0  ,0  ,0  ,0  ,0  ,0  ,0  ,0  ,0  ,0  ,0  ,0  ,0  ,0  ,0  ,0  ,0  ,0  ,0  ,2  ,2  ,2  ,2  ,2  ,2  ,2  ,2  ,2  ,2  ,2  ,2  ,2  ,2  ,2  ,2  ,0  ,0  ,0  ,0  
0  ,0  ,0  ,0  ,0  ,0  ,0  ,0  ,0  ,0  ,0  ,0  ,0  ,0  ,0  ,0  ,0  ,0  ,0  ,0  ,0  ,0  ,0  ,0  ,0  ,0  ,0  ,0  ,0  ,0  ,0  ,0  ,0  ,0  ,0  ,0  ,0  ,0  ,0  ,0  ,0  ,0  ,0  ,0  ,0  ,0  ,0  ,0  ,0  ,0  ,0  ,0  ,0  ,0  ,0  
0  ,0  ,0  ,0  ,0  ,0  ,0  ,0  ,0  ,0  ,0  ,0  ,0  ,0  ,0  ,0  ,0  ,0  ,0  ,0  ,0  ,0  ,0  ,0  ,0  ,0  ,0  ,0  ,0  ,0  ,0  ,0  ,0  ,0  ,0  ,0  ,0  ,0  ,0  ,0  ,0  ,0  ,0  ,0  ,0  ,0  ,0  ,0  ,0  ,0  ,0  ,0  ,0  ,0  ,0  
0  ,0  ,0  ,0  ,0  ,0  ,0  ,0  ,0  ,0  ,0  ,0  ,0  ,0  ,0  ,0  ,0  ,0  ,0  ,0  ,0  ,0  ,0  ,0  ,0  ,0  ,0  ,0  ,0  ,0  ,0  ,0  ,0  ,0  ,0  ,0  ,0  ,0  ,0  ,0  ,0  ,0  ,0  ,0  ,0  ,0  ,0  ,0  ,0  ,0  ,0  ,0  ,0  ,0  ,0  
0  ,0  ,0  ,0  ,0  ,0  ,0  ,0  ,0  ,0  ,0  ,0  ,0  ,0  ,0  ,0  ,0  ,0  ,0  ,0  ,0  ,0  ,0  ,0  ,0  ,0  ,0  ,0  ,0  ,0  ,0  ,0  ,0  ,0  ,0  ,0  ,0  ,0  ,0  ,0  ,0  ,0  ,0  ,0  ,0  ,0  ,0  ,0  ,0  ,0  ,0  ,0  ,0  ,0  ,0  
0  ,0  ,0  ,0  ,0  ,0  ,0  ,0  ,0  ,0  ,0  ,0  ,0  ,0  ,0  ,0  ,0  ,0  ,0  ,0  ,0  ,0  ,0  ,0  ,0  ,0  ,0  ,0  ,0  ,0  ,0  ,0  ,0  ,0  ,0  ,0  ,0  ,0  ,0  ,0  ,0  ,0  ,0  ,0  ,0  ,0  ,0  ,0  ,0  ,0  ,0  ,0  ,0  ,0  ,0  
0  ,0  ,0  ,0  ,0  ,0  ,0  ,0  ,0  ,0  ,0  ,0  ,0  ,0  ,0  ,0  ,0  ,0  ,0  ,0  ,0  ,0  ,0  ,0  ,0  ,0  ,0  ,0  ,0  ,0  ,0  ,0  ,0  ,0  ,0  ,0  ,0  ,0  ,0  ,0  ,0  ,0  ,0  ,0  ,0  ,0  ,0  ,0  ,0  ,0  ,0  ,0  ,0  ,0  ,0  
0  ,0  ,0  ,0  ,0  ,0  ,0  ,0  ,0  ,0  ,0  ,0  ,0  ,0  ,0  ,0  ,0  ,0  ,0  ,0  ,0  ,0  ,0  ,0  ,0  ,0  ,0  ,0  ,0  ,0  ,0  ,0  ,0  ,0  ,0  ,0  ,0  ,0  ,0  ,0  ,0  ,0  ,0  ,0  ,0  ,0  ,0  ,0  ,0  ,0  ,0  ,0  ,0  ,0  ,0  
0  ,0  ,0  ,0  ,0  ,0  ,0  ,0  ,0  ,0  ,0  ,0  ,0  ,0  ,0  ,0  ,0  ,0  ,0  ,0  ,0  ,0  ,0  ,0  ,0  ,0  ,0  ,0  ,0  ,0  ,0  ,0  ,0  ,0  ,0  ,0  ,0  ,0  ,0  ,0  ,0  ,0  ,0  ,0  ,0  ,0  ,0  ,0  ,0  ,0  ,0  ,0  ,0  ,0  ,0  
0  ,0  ,0  ,0  ,0  ,0  ,0  ,0  ,0  ,0  ,0  ,0  ,0  ,0  ,0  ,0  ,0  ,0  ,0  ,0  ,0  ,0  ,0  ,0  ,0  ,0  ,0  ,0  ,0  ,0  ,0  ,0  ,0  ,0  ,0  ,0  ,0  ,0  ,0  ,0  ,0  ,0  ,0  ,0  ,0  ,0  ,0  ,0  ,0  ,0  ,0  ,0  ,0  ,0  ,0  
0  ,0  ,0  ,0  ,0  ,0  ,0  ,0  ,0  ,0  ,0  ,0  ,0  ,0  ,0  ,0  ,0  ,0  ,0  ,0  ,0  ,0  ,0  ,0  ,0  ,0  ,0  ,0  ,0  ,0  ,0  ,0  ,0  ,0  ,0  ,0  ,0  ,0  ,0  ,0  ,0  ,0  ,0  ,0  ,0  ,0  ,0  ,0  ,0  ,0  ,0  ,0  ,0  ,0  ,0  
0  ,0  ,0  ,0  ,0  ,0  ,0  ,0  ,0  ,0  ,0  ,0  ,0  ,0  ,0  ,0  ,0  ,0  ,0  ,0  ,0  ,0  ,0  ,0  ,0  ,0  ,0  ,0  ,0  ,0  ,0  ,0  ,0  ,0  ,0  ,0  ,0  ,0  ,0  ,0  ,0  ,0  ,0  ,0  ,0  ,0  ,0  ,0  ,0  ,0  ,0  ,0  ,0  ,0  ,0  
0  ,0  ,0  ,0  ,0  ,0  ,0  ,0  ,0  ,0  ,0  ,0  ,0  ,0  ,0  ,0  ,0  ,0  ,0  ,0  ,0  ,0  ,0  ,0  ,0  ,0  ,0  ,0  ,0  ,0  ,0  ,0  ,0  ,0  ,0  ,0  ,0  ,0  ,0  ,0  ,0  ,0  ,0  ,0  ,0  ,0  ,0  ,0  ,0  ,0  ,0  ,0  ,0  ,0  ,0  
0  ,0  ,0  ,0  ,0  ,0  ,0  ,0  ,0  ,0  ,0  ,0  ,0  ,0  ,0  ,0  ,0  ,0  ,0  ,0  ,0  ,0  ,0  ,0  ,0  ,0  ,0  ,0  ,0  ,0  ,0  ,0  ,0  ,0  ,0  ,0  ,0  ,0  ,0  ,0  ,0  ,0  ,0  ,0  ,0  ,0  ,0  ,0  ,0  ,0  ,0  ,0  ,0  ,0  ,0  
0  ,0  ,0  ,0  ,0  ,0  ,0  ,0  ,0  ,0  ,0  ,0  ,0  ,0  ,0  ,0  ,0  ,0  ,0  ,0  ,0  ,0  ,0  ,0  ,0  ,0  ,0  ,0  ,0  ,0  ,0  ,0  ,0  ,0  ,0  ,0  ,0  ,0  ,0  ,0  ,0  ,0  ,0  ,0  ,0  ,0  ,0  ,0  ,0  ,0  ,0  ,0  ,0  ,0  ,0  
0  ,0  ,0  ,0  ,0  ,0  ,0  ,0  ,0  ,0  ,0  ,0  ,0  ,0  ,0  ,0  ,0  ,0  ,0  ,0  ,0  ,0  ,0  ,0  ,0  ,0  ,0  ,0  ,0  ,0  ,0  ,0  ,0  ,0  ,0  ,0  ,0  ,0  ,0  ,0  ,0  ,0  ,0  ,0  ,0  ,0  ,0  ,0  ,0  ,0  ,0  ,0  ,0  ,0  ,0  
0  ,0  ,0  ,0  ,0  ,0  ,0  ,0  ,0  ,0  ,0  ,0  ,0  ,0  ,0  ,0  ,0  ,0  ,0  ,0  ,0  ,0  ,0  ,0  ,0  ,0  ,0  ,0  ,0  ,0  ,0  ,0  ,0  ,0  ,0  ,0  ,0  ,0  ,0  ,0  ,0  ,0  ,0  ,0  ,0  ,0  ,0  ,0  ,0  ,0  ,0  ,0  ,0  ,0  ,0  
0  ,0  ,0  ,0  ,0  ,0  ,0  ,0  ,0  ,0  ,0  ,0  ,0  ,0  ,0  ,0  ,0  ,0  ,0  ,0  ,0  ,0  ,0  ,0  ,0  ,0  ,0  ,0  ,0  ,0  ,0  ,0  ,0  ,0  ,0  ,0  ,0  ,0  ,0  ,0  ,0  ,0  ,0  ,0  ,0  ,0  ,0  ,0  ,0  ,0  ,0  ,0  ,0  ,0  ,0  
0  ,0  ,0  ,0  ,0  ,0  ,0  ,0  ,0  ,0  ,0  ,0  ,0  ,0  ,0  ,0  ,0  ,0  ,0  ,0  ,0  ,0  ,0  ,0  ,0  ,0  ,0  ,0  ,0  ,0  ,0  ,0  ,0  ,0  ,0  ,0  ,0  ,0  ,0  ,0  ,0  ,0  ,0  ,0  ,0  ,0  ,0  ,0  ,0  ,0  ,0  ,0  ,0  ,0  ,0  
0  ,0  ,0  ,0  ,0  ,0  ,0  ,0  ,0  ,0  ,0  ,0  ,0  ,0  ,0  ,0  ,0  ,0  ,0  ,0  ,0  ,0  ,0  ,0  ,0  ,0  ,0  ,0  ,0  ,0  ,0  ,0  ,0  ,0  ,0  ,0  ,0  ,0  ,0  ,0  ,0  ,0  ,0  ,0  ,0  ,0  ,0  ,0  ,0  ,0  ,0  ,0  ,0  ,0  ,0  
0  ,0  ,0  ,0  ,0  ,0  ,0  ,0  ,0  ,0  ,0  ,0  ,0  ,0  ,0  ,0  ,0  ,0  ,0  ,0  ,0  ,0  ,0  ,0  ,0  ,0  ,0  ,0  ,0  ,0  ,0  ,0  ,0  ,0  ,0  ,0  ,0  ,0  ,0  ,0  ,0  ,0  ,0  ,0  ,0  ,0  ,0  ,0  ,0  ,0  ,0  ,0  ,0  ,0  ,0  
0  ,0  ,0  ,0  ,0  ,0  ,0  ,0  ,0  ,0  ,0  ,0  ,0  ,0  ,0  ,0  ,0  ,0  ,0  ,0  ,0  ,0  ,0  ,0  ,0  ,0  ,0  ,0  ,0  ,0  ,0  ,0  ,0  ,0  ,0  ,0  ,0  ,0  ,0  ,0  ,0  ,0  ,0  ,0  ,0  ,0  ,0  ,0  ,0  ,0  ,0  ,0  ,0  ,0  ,0  
0  ,0  ,0  ,0  ,0  ,0  ,0  ,0  ,0  ,0  ,0  ,0  ,0  ,0  ,0  ,0  ,0  ,0  ,0  ,0  ,0  ,0  ,0  ,0  ,0  ,0  ,0  ,0  ,0  ,0  ,0  ,0  ,0  ,0  ,0  ,0  ,0  ,0  ,0  ,0  ,0  ,0  ,0  ,0  ,0  ,0  ,0  ,0  ,0  ,0  ,0  ,0  ,0  ,0  ,0  
10 ,10 ,10 ,10 ,10 ,10 ,10 ,10 ,10 ,10 ,10 ,10 ,10 ,10 ,10 ,10 ,10 ,10 ,10 ,10 ,10 ,10 ,10 ,10 ,10 ,10 ,10 ,10 ,10 ,10 ,10 ,10 ,10 ,10 ,10 ,10 ,10 ,10 ,10 ,10 ,10 ,10 ,10 ,10 ,10 ,10 ,10 ,10 ,10 ,10 ,10 ,10 ,10 ,10 ,10 
10 ,10 ,10 ,10 ,10 ,10 ,10 ,10 ,10 ,10 ,10 ,10 ,10 ,10 ,10 ,10 ,10 ,10 ,10 ,10 ,10 ,10 ,10 ,10 ,10 ,10 ,10 ,10 ,10 ,10 ,10 ,10 ,10 ,10 ,10 ,10 ,10 ,10 ,10 ,10 ,10 ,10 ,10 ,10 ,10 ,10 ,10 ,10 ,10 ,10 ,10 ,10 ,10 ,10 ,10 
10 ,10 ,10 ,10 ,10 ,10 ,10 ,10 ,10 ,10 ,10 ,10 ,10 ,10 ,10 ,10 ,10 ,10 ,10 ,10 ,10 ,10 ,10 ,10 ,10 ,10 ,10 ,10 ,10 ,10 ,10 ,10 ,10 ,10 ,10 ,10 ,10 ,10 ,10 ,10 ,10 ,10 ,10 ,10 ,10 ,10 ,10 ,10 ,10 ,10 ,10 ,10 ,10 ,10 ,10 
1  ,1  ,1  ,1  ,1  ,1  ,1  ,1  ,1  ,1  ,1  ,1  ,1  ,1  ,1  ,1  ,1  ,1  ,1  ,1  ,1  ,1  ,1  ,1  ,1  ,1  ,1  ,1  ,1  ,1  ,1  ,1  ,1  ,1  ,1  ,1  ,1  ,1  ,1  ,1  ,1  ,1  ,1  ,1  ,1  ,1  ,1  ,1  ,1  ,1  ,1  ,1  ,1  ,1  ,1  
1  ,1  ,1  ,1  ,1  ,1  ,1  ,1  ,1  ,1  ,1  ,1  ,1  ,1  ,1  ,1  ,1  ,1  ,1  ,1  ,1  ,1  ,1  ,1  ,1  ,1  ,1  ,1  ,1  ,1  ,1  ,1  ,1  ,1  ,1  ,1  ,1  ,1  ,1  ,1  ,1  ,1  ,1  ,1  ,1  ,1  ,1  ,1  ,1  ,1  ,1  ,1  ,1  ,1  ,1  
1  ,1  ,1  ,1  ,1  ,1  ,1  ,1  ,1  ,1  ,1  ,1  ,1  ,1  ,1  ,1  ,1  ,1  ,1  ,1  ,1  ,1  ,1  ,1  ,1  ,1  ,1  ,1  ,1  ,1  ,1  ,1  ,1  ,1  ,1  ,1  ,1  ,1  ,1  ,1  ,1  ,1  ,1  ,1  ,1  ,1  ,1  ,1  ,1  ,1  ,1  ,1  ,1  ,1  ,1  
1  ,1  ,1  ,1  ,1  ,1  ,1  ,1  ,1  ,1  ,1  ,1  ,1  ,1  ,1  ,1  ,1  ,1  ,1  ,1  ,1  ,1  ,1  ,1  ,1  ,1  ,1  ,1  ,1  ,1  ,1  ,1  ,1  ,1  ,1  ,1  ,1  ,1  ,1  ,1  ,1  ,1  ,1  ,1  ,1  ,1  ,1  ,1  ,1  ,1  ,1  ,1  ,1  ,1  ,1  
1  ,1  ,1  ,1  ,1  ,1  ,1  ,1  ,1  ,1  ,1  ,1  ,1  ,1  ,1  ,1  ,1  ,1  ,1  ,1  ,1  ,1  ,1  ,1  ,1  ,1  ,1  ,1  ,1  ,1  ,1  ,1  ,1  ,1  ,1  ,1  ,1  ,1  ,1  ,1  ,1  ,1  ,1  ,1  ,1  ,1  ,1  ,1  ,1  ,1  ,1  ,1  ,1  ,1  ,1  
1  ,1  ,1  ,1  ,1  ,1  ,1  ,1  ,1  ,1  ,1  ,1  ,1  ,1  ,1  ,1  ,1  ,1  ,1  ,1  ,1  ,1  ,1  ,1  ,1  ,1  ,1  ,1  ,1  ,1  ,1  ,1  ,1  ,1  ,1  ,1  ,1  ,1  ,1  ,1  ,1  ,1  ,1  ,1  ,1  ,1  ,1  ,1  ,1  ,1  ,1  ,1  ,1  ,1  ,1  
1  ,1  ,1  ,1  ,1  ,1  ,1  ,1  ,1  ,1  ,1  ,1  ,1  ,1  ,1  ,1  ,1  ,1  ,1  ,1  ,1  ,1  ,1  ,1  ,1  ,1  ,1  ,1  ,1  ,1  ,1  ,1  ,1  ,1  ,1  ,1  ,1  ,1  ,1  ,1  ,1  ,1  ,1  ,1  ,1  ,1  ,1  ,1  ,1  ,1  ,1  ,1  ,1  ,1  ,1  
1  ,1  ,1  ,1  ,1  ,1  ,1  ,1  ,1  ,1  ,1  ,1  ,1  ,1  ,1  ,1  ,1  ,1  ,1  ,1  ,1  ,1  ,1  ,1  ,1  ,1  ,1  ,1  ,1  ,1  ,1  ,1  ,1  ,1  ,1  ,1  ,1  ,1  ,1  ,1  ,1  ,1  ,1  ,1  ,1  ,1  ,1  ,1  ,1  ,1  ,1  ,1  ,1  ,1  ,1  
1  ,1  ,1  ,1  ,1  ,1  ,1  ,1  ,1  ,1  ,1  ,1  ,1  ,1  ,1  ,1  ,1  ,1  ,1  ,1  ,1  ,1  ,1  ,1  ,1  ,1  ,1  ,1  ,1  ,1  ,1  ,1  ,1  ,1  ,1  ,1  ,1  ,1  ,1  ,1  ,1  ,1  ,1  ,1  ,1  ,1  ,1  ,1  ,1  ,1  ,1  ,1  ,1  ,1  ,1  
1  ,1  ,1  ,1  ,1  ,1  ,1  ,1  ,1  ,1  ,1  ,1  ,1  ,1  ,1  ,1  ,1  ,1  ,1  ,1  ,1  ,1  ,1  ,1  ,1  ,1  ,1  ,1  ,1  ,1  ,1  ,1  ,1  ,1  ,1  ,1  ,1  ,1  ,1  ,1  ,1  ,1  ,1  ,1  ,1  ,1  ,1  ,1  ,1  ,1  ,1  ,1  ,1  ,1  ,1  
1  ,1  ,1  ,1  ,1  ,1  ,1  ,1  ,1  ,1  ,1  ,1  ,1  ,1  ,1  ,1  ,1  ,1  ,1  ,1  ,1  ,1  ,1  ,1  ,1  ,1  ,1  ,1  ,1  ,1  ,1  ,1  ,1  ,1  ,1  ,1  ,1  ,1  ,1  ,1  ,1  ,1  ,1  ,1  ,1  ,1  ,1  ,1  ,1  ,1  ,1  ,1  ,1  ,1  ,1  
1  ,1  ,1  ,1  ,1  ,1  ,1  ,1  ,1  ,1  ,1  ,1  ,1  ,1  ,1  ,1  ,1  ,1  ,1  ,1  ,1  ,1  ,1  ,1  ,1  ,1  ,1  ,1  ,1  ,1  ,1  ,1  ,1  ,1  ,1  ,1  ,1  ,1  ,1  ,1  ,1  ,1  ,1  ,1  ,1  ,1  ,1  ,1  ,1  ,1  ,1  ,1  ,1  ,1  ,1  
1  ,1  ,1  ,1  ,1  ,1  ,1  ,1  ,1  ,1  ,1  ,1  ,1  ,1  ,1  ,1  ,1  ,1  ,1  ,1  ,1  ,1  ,1  ,1  ,1  ,1  ,1  ,1  ,1  ,1  ,1  ,1  ,1  ,1  ,1  ,1  ,1  ,1  ,1  ,1  ,1  ,1  ,1  ,1  ,1  ,1  ,1  ,1  ,1  ,1  ,1  ,1  ,1  ,1  ,1  
1  ,1  ,1  ,1  ,1  ,1  ,1  ,1  ,1  ,1  ,1  ,1  ,1  ,1  ,1  ,1  ,1  ,1  ,1  ,1  ,1  ,1  ,1  ,1  ,1  ,1  ,1  ,1  ,1  ,1  ,1  ,1  ,1  ,1  ,1  ,1  ,1  ,1  ,1  ,1  ,1  ,1  ,1  ,1  ,1  ,1  ,1  ,1  ,1  ,1  ,1  ,1  ,1  ,1  ,1  
1  ,1  ,1  ,1  ,1  ,1  ,1  ,1  ,1  ,1  ,1  ,1  ,1  ,1  ,1  ,1  ,1  ,1  ,1  ,1  ,1  ,1  ,1  ,1  ,1  ,1  ,1  ,1  ,1  ,1  ,1  ,1  ,1  ,1  ,1  ,1  ,1  ,1  ,1  ,1  ,1  ,1  ,1  ,1  ,1  ,1  ,1  ,1  ,1  ,1  ,1  ,1  ,1  ,1  ,1  
1  ,1  ,1  ,1  ,1  ,1  ,1  ,1  ,1  ,1  ,1  ,1  ,1  ,1  ,1  ,1  ,1  ,1  ,1  ,1  ,1  ,1  ,1  ,1  ,1  ,1  ,1  ,1  ,1  ,1  ,1  ,1  ,1  ,1  ,1  ,1  ,1  ,1  ,1  ,1  ,1  ,1  ,1  ,1  ,1  ,1  ,1  ,1  ,1  ,1  ,1  ,1  ,1  ,1  ,1  
   