12, 12, 12, 12, 12,  5,  0,  2, 16, 16, 16, 16, 16, 16, 16, 16, 16, 16, 16, 16, 16, 16, 16, 16, 16, 16, 16, 16, 16, 16, 16, 16, 16, 16, 16, 16, 16, 16, 16, 16, 16, 16, 16, 16, 16, 16, 16, 16, 16, 16
12, 12, 12, 12, 12,  5,  0,  2, 16, 16, 16, 16, 16, 16, 16, 16, 16, 16, 16, 16, 16, 16, 16, 16, 16, 16, 16, 16, 16, 16, 16, 16, 16, 16, 16, 16, 16, 16, 16, 16, 16, 16, 16, 16, 16, 16, 16, 16, 16, 16
12, 12, 12, 12, 12,  5,  0,  2, 16, 16, 16, 16, 16, 16, 16, 16, 16, 16, 16, 16, 16, 16, 16, 16, 16, 16, 16, 16, 16, 16, 16, 16, 16, 16, 16, 16, 16, 16, 16, 16, 16, 16, 16, 16, 16, 16, 16, 16, 16, 16
12, 12, 12, 12, 12,  5,  0,  2, 16, 16, 16, 16, 16, 16, 16, 16, 16, 16, 16, 16, 16,  4,  4,  4,  4,  4,  4,  4,  4,  4, 16, 16, 16, 16, 16, 16, 16, 16, 16, 16, 16, 16, 16, 16, 16, 16, 16, 16, 16, 16
12, 12, 12, 12, 12,  5,  0,  2, 16, 16, 16, 16, 16, 16, 16, 16,  2,  2,  2, 16, 16,  4,  4,  4,  4,  4,  4,  4,  4,  4, 16, 16, 16, 16, 16, 16, 16, 16, 16, 16, 16, 16, 16, 16, 16, 16, 16, 16, 16, 16
12, 12, 12, 12, 12,  5,  0,  2, 16, 16, 16, 16, 16, 16, 16, 16, 14, 14,  2, 16, 16, 16, 16, 16, 16, 16, 16, 16,  4,  4, 16, 16, 16, 16, 16, 16, 16, 16, 16, 16, 16, 16, 16, 16, 16, 16, 16, 16, 16, 16
12, 12, 12, 12, 12,  5,  0,  2, 16, 16, 16, 16, 16, 16, 16, 16, 14, 14,  2, 16, 16, 16, 16, 16, 16, 16, 16, 16,  4,  4, 16, 16, 16, 16, 16, 16, 16, 16, 16, 16, 16, 16, 16, 16, 16, 16, 16, 16, 16, 16
12, 12, 12, 12, 12,  5,  0,  2, 16, 16, 16, 16, 16, 16, 16, 16, 14, 14,  2, 16, 16, 16, 16, 16, 16, 16, 16, 16, 16, 16, 16, 16, 16, 16, 16, 16, 16, 16, 16, 16, 16, 16, 16, 16, 16, 16, 16, 16, 16, 16
12, 12, 12, 12, 12,  5,  0,  2, 16, 16, 16, 16, 16, 16, 16, 16, 14, 14,  2, 16, 16, 16, 16, 16, 16, 16, 16, 16, 16, 16, 16, 16, 16, 16, 16, 16, 16, 16, 16, 16, 16, 16, 16, 16, 16, 16, 16, 16, 16, 16
12, 12, 12, 12, 12,  5,  0,  2, 16, 16, 16, 16, 16, 16, 16, 16, 14, 14,  2, 16, 15, 15, 15, 16, 15, 15, 15, 16, 15, 15, 15, 16, 16, 16, 16, 16, 16, 16, 16, 16, 16, 16, 16, 16, 16, 16, 16, 16, 16, 16
12, 12, 12, 12, 12,  5,  0,  2, 16, 16, 16, 16, 16, 16, 16, 16, 16, 16, 16, 16, 15, 15, 15, 16, 15, 15, 15, 16, 15, 15, 15, 16, 16, 16, 16, 16, 16, 16, 16, 16, 16, 16, 16, 16, 16, 16, 16, 16, 16, 16
12, 12, 12, 12, 12,  5,  0,  2, 16, 16, 16, 16, 16, 16, 16, 16, 16, 16, 16, 16, 15, 15, 15, 16, 15, 15, 15, 16, 15, 15, 15, 16, 16, 16, 16,  0,  0,  0,  0, 16, 16, 16, 16, 16, 16, 16, 16, 16, 16, 16
12, 12, 12, 12, 12,  5,  0,  2, 16, 16, 16, 16, 16, 16, 16, 16, 16, 16, 16, 16, 15, 15, 15, 16, 15, 15, 15, 16, 15, 15, 15, 16, 16, 16, 16,  0,  0,  0,  0, 16, 16, 16, 16, 16, 16, 16, 16, 16, 16, 16
12, 12, 12, 12, 12,  5,  0,  2, 16, 16, 16, 16, 16, 16, 16, 16, 16, 16, 16, 16, 15, 15, 15, 16, 15, 15, 15, 16, 15, 15, 15, 16, 16, 16, 16,  0,  0,  0,  0, 16, 16, 16, 16, 16, 16, 16, 16, 16, 16, 16
12, 12, 12, 12, 12,  5,  0,  2, 16, 16, 16, 16, 16, 16, 16, 16, 16, 16, 16, 16, 15, 15, 15, 16, 15, 15, 15, 16, 15,  0,  0,  0, 16, 16, 16, 16, 16, 16, 16, 16, 16, 16, 16, 16, 16, 16, 16, 16, 16, 16
12, 12, 12, 12, 12,  5,  0,  2, 16, 16, 16, 16, 16, 16, 16, 16, 16, 16, 16, 16, 15, 15, 15, 16, 15, 15, 15, 16, 15,  0,  0,  0, 16, 16, 16, 16, 16, 16, 16, 16, 16, 16, 16, 16, 16, 16, 16, 16, 16, 16
12, 12, 12, 12, 12,  5,  0,  2, 16, 16, 16, 16, 16, 16, 16, 16, 16, 16, 15, 15, 15, 15, 15, 16, 15, 15, 15, 16, 15, 15, 15, 16, 16, 16, 16, 16, 16, 16, 16, 16, 16, 16, 16, 16, 16, 16, 16, 16, 16, 16
12, 12, 12, 12, 12,  5,  0,  2, 16, 16, 16, 16, 16, 16, 16, 16, 16, 16, 15, 15, 15, 15, 15, 16, 15, 15, 15, 16, 15, 15, 15, 16, 16, 16, 16, 16, 16, 16, 16, 16, 16, 16, 16, 16, 16, 16, 16, 16, 16, 16
12, 12, 12, 12, 12,  5,  0,  2, 16, 16, 16, 16, 16, 16, 16, 16, 16, 16, 16, 16, 15, 15, 15, 16, 15, 15, 15, 16, 15, 15, 15, 16, 16, 16, 16, 16, 16, 16, 16, 16, 16, 16, 16, 16, 16, 16, 16, 16, 16, 16
12, 12, 12, 12, 12,  5,  0,  2, 16, 16, 16, 16, 16, 16, 16, 16, 16, 16, 16, 16, 15, 15,  0,  0,  0,  0,  0,  0,  0,  0,  0, 16, 16, 16, 16,  0,  0,  0,  0, 16, 16, 16, 16, 16, 16, 16, 16, 16, 16, 16
12, 12, 12, 12, 12,  5,  0,  2, 16, 16, 16, 16, 16, 16, 16, 16, 16, 16, 16, 16, 15, 15,  0,  0,  0,  0,  0,  0,  0,  0,  0, 16, 16, 16, 16,  0,  0,  0,  0, 16, 16, 16, 16, 16, 16, 16, 16, 16, 16, 16
12, 12, 12, 12, 12,  5,  0,  2, 16, 16, 16, 16, 16,  2,  2,  2, 16, 16, 16, 16, 16, 16,  0,  0,  0,  0,  0,  0,  0,  0,  0, 16, 16, 16, 16,  0,  0,  0,  0, 16, 16, 16, 16, 16, 16, 16, 16, 16, 16, 16
12, 12, 12, 12, 12,  5,  0,  2, 16, 16, 16, 16, 16, 14, 14, 14, 16, 16, 16, 16, 16, 16, 16, 16, 16, 16, 16, 16, 16, 16, 16, 16, 16, 16, 16, 16, 16, 16, 16, 16, 16, 16, 16, 16, 16, 16, 16, 16, 16, 16
12, 12, 12, 12, 12,  5,  0,  2, 16, 16, 16, 16, 16, 14, 14, 14, 16, 16, 16, 16, 16, 16, 16, 16, 16, 16, 16, 16, 16, 16, 16, 16, 16, 16, 16, 16, 16, 16, 16, 16, 16, 16, 16, 16, 16, 16, 16, 16, 16, 16
12, 12, 12, 12, 12,  5,  0,  2, 16, 16, 16, 16, 16, 14, 14, 14, 16, 16, 16, 16, 16, 16, 16, 16, 16, 16, 16, 16, 16, 16, 16, 16, 16, 16, 16, 16, 16, 16, 16, 16, 16, 16, 16, 16, 16, 16, 16, 16, 16, 16
12, 12, 12, 12, 12,  5,  0,  2, 16, 16, 16, 16, 16, 14, 14,  2, 16, 16, 16, 16, 16, 16, 16, 16, 16, 16, 16, 16, 16, 16, 16, 16, 16, 16, 16, 16, 16, 16, 16, 16, 16, 16, 16, 16, 16, 16, 16, 16, 16, 16
12, 12, 12, 12, 12,  5,  0,  2, 16, 16, 16, 16, 16, 14, 14,  2, 16, 16, 16, 16, 16, 16, 16, 16, 16, 16, 16, 16, 16, 16, 16, 16, 16, 16, 16, 16, 16, 16, 16, 16, 16, 16, 16, 16, 16, 16, 16, 16, 16, 16
12, 12, 12, 12, 12,  5,  0,  2, 16, 16, 16, 16, 16, 14, 14,  2, 16, 16, 16, 16, 16, 16, 16, 16, 16, 16, 16, 16, 16, 16, 16, 16, 16, 16, 16, 16, 16, 16, 16, 16, 16, 16, 16, 16, 16, 16, 16, 16, 16, 16
12, 12, 12, 12, 12,  5,  0,  2, 16, 16, 16, 16, 16, 14, 14,  0, 16, 16, 16, 16, 16, 16, 16, 16, 16, 16, 16, 16, 16, 16, 16, 16, 16, 16, 16, 16, 16, 16, 16, 16, 16, 16, 16, 16, 16, 16, 16, 16, 16, 16
12, 12, 12, 12, 12,  5,  0,  2, 16, 16, 16, 16, 16, 14, 14,  0,  2, 16, 16, 16, 16, 16, 16, 16, 16, 16, 16, 16, 16, 16, 16, 16, 16, 16, 16,  0,  0, 16, 16, 16, 16, 16, 16, 16, 16, 16, 16, 16, 16, 16
12, 12, 12, 12, 12,  5,  0,  2, 16, 16, 16, 16, 16, 14, 14,  0,  2, 16, 16, 16, 16, 16, 16, 16, 16, 16, 16, 16, 16, 16, 16, 16, 16, 16, 16,  0,  0, 16, 16, 16, 16, 16, 16, 16, 16, 16, 16, 16, 16, 16
12, 12, 12, 12, 12,  5,  0,  2, 16, 16, 16, 16, 16, 14, 14,  0,  2, 16, 16, 16, 16, 16, 16, 16, 16, 16, 16, 16, 16, 16, 16, 16, 16, 16, 16,  0,  0, 16, 16, 16, 16, 16, 16, 16, 16, 16, 16, 16, 16, 16
12, 12, 12, 12, 12,  5,  0,  2, 16, 16, 16, 16, 16, 14, 14,  0,  2, 16, 16, 16, 16, 16, 16, 16, 16, 16, 16, 16, 16, 16, 16, 16, 16, 16, 16,  0,  0, 16, 16, 16, 16, 16, 16, 16, 16, 16, 16, 16, 16, 16
12, 12, 12, 12, 12,  5,  0,  2, 16, 16, 16, 16, 16, 14, 14,  0,  2, 16, 16, 16, 16, 16, 16, 16, 16, 16, 16, 16, 16, 16, 16, 16, 16, 16, 16,  0,  0, 16, 16, 16, 16, 16, 16, 16, 16, 16, 16, 16, 16, 16
12, 12, 12, 12, 12,  5,  0,  2, 16, 16, 16, 16, 16, 14, 14,  0,  2, 16, 16, 16, 16, 16, 16, 16, 16, 16, 16, 16, 16, 16, 16, 16, 16, 16, 16,  0,  0, 16, 16, 16, 16, 16, 16, 16, 16, 16, 16, 16, 16, 16
12, 12, 12, 12, 12,  5,  0,  2, 16, 16, 16, 16, 16,  0,  0,  0,  2, 16, 16, 16, 16, 16, 16, 16, 16, 16, 16, 16, 16, 16, 16, 16, 16, 16, 16,  0,  0, 16, 16, 16, 16, 16, 16, 16, 16, 16, 16, 16, 16, 16
12, 12, 12, 12, 12,  5,  0,  2, 16, 16, 16, 16, 16, 16, 16, 16, 16, 16, 16, 16, 16, 16, 16, 16, 16, 16, 16, 16, 16, 16, 16, 16, 16, 16, 16,  0,  0, 16, 16, 16, 16, 16, 16, 16, 16, 16, 16, 16, 16, 16
12, 12, 12, 12, 12,  5,  0,  2, 16, 16, 16, 16, 16, 16, 16, 16, 16, 16, 16, 16, 16, 16, 16, 16, 16, 16, 16, 16, 16, 16, 16, 16, 16, 16, 16,  0,  0, 16, 16, 16, 16, 16, 16, 16, 16, 16, 16, 16, 16, 16
12, 12, 12, 12, 12,  5,  0,  2, 16, 16, 16, 16, 16, 16, 16, 16,  2, 16, 16, 16, 16, 16, 16, 16, 16, 16, 16, 16, 16, 16, 16, 16, 16, 16, 16, 16, 16, 16, 16, 16, 16, 16, 16, 16, 16, 16, 16, 16, 16, 16
12, 12, 12, 12, 12,  5,  0,  2, 16, 16, 16, 16, 16, 16, 16, 16,  2, 16, 16, 16, 16, 16, 16, 16, 16, 16, 16, 16, 16, 16, 16, 16, 16, 16, 16, 16, 16, 16, 16, 16, 16, 16, 16, 16, 16, 16, 16, 16, 16, 16
12, 12, 12, 12, 12,  5,  0,  2, 16, 16, 16, 16, 16, 16, 16, 16,  2, 16, 16, 16, 16, 16, 16, 16, 16, 16, 16, 16, 16, 16, 16, 16, 16, 16, 16, 16, 16, 16, 16, 16, 16, 16, 16, 16, 16, 16, 16, 16, 16, 16
12, 12, 12, 12, 12,  5,  0,  2, 16, 16, 16, 16, 16, 16, 16,  2,  2,  0,  0,  0, 16, 16, 16, 16, 16, 16, 16, 16, 16, 16, 16, 16, 16, 16, 16, 16, 16, 16, 16, 16, 16, 16, 16, 16, 16, 16, 16, 16, 16, 16
12, 12, 12, 12, 12,  5,  0,  2, 16, 16, 16, 16, 16, 16, 16, 14,  0,  2,  0,  0, 16, 16, 16, 16, 16, 16, 16, 16, 16, 16, 16, 16, 16, 16, 16, 16, 16, 16, 16, 16, 16, 16, 16, 16, 16, 16, 16, 16, 16, 16
12, 12, 12, 12, 12,  5,  0,  2, 16, 16, 16, 16, 16, 16, 16, 14,  0,  2,  0,  0, 16, 16, 16, 16, 16, 16, 16, 16, 16, 16, 16, 16, 16, 16, 16, 16, 16, 16, 16, 16, 16, 16, 16, 16, 16, 16, 16, 16, 16, 16
12, 12, 12, 12, 12,  5,  0,  2, 16, 16, 16, 16, 16, 16, 16, 14,  0,  2,  2,  0, 16, 16, 16, 16, 16, 16, 16, 16, 16, 16, 16, 16, 16, 16, 16, 16, 16, 16, 16, 16, 16, 16, 16, 16, 16, 16, 16, 16, 16, 16
12, 12, 12, 12, 12,  5,  0,  2, 16, 16, 16, 16, 16, 16, 16, 14, 14,  2,  2,  0, 16, 16, 16, 16, 16, 16, 16, 16, 16, 16, 16, 16, 16, 16, 16, 16, 16, 16, 16, 16, 16, 16, 16, 16, 16, 16, 16, 16, 16, 16
12, 12, 12, 12, 12,  5,  0,  2, 16, 16, 16, 16, 16, 16, 16, 14, 14,  2,  2,  0, 16, 16, 16, 16, 16, 16, 16, 16, 16, 16, 16, 16, 16, 16, 16, 16, 16, 16, 16, 16, 16, 16, 16, 16, 16, 16, 16, 16, 16, 16
12, 12, 12, 12, 12,  5,  0,  2, 16, 16, 16, 16, 16, 16, 16, 14, 14,  2,  2,  0, 16, 16, 16, 16, 16, 16, 16, 16, 16, 16, 16, 16, 16, 16, 16, 16, 16, 16, 16, 16, 16, 16, 16, 16, 16, 16, 16, 16, 16, 16
12, 12, 12, 12, 12,  5,  0,  2, 16, 16, 16, 16, 16, 16, 16, 14, 14,  0,  2,  0, 16, 16, 16, 16, 16, 16, 16, 16, 16, 16, 16, 16, 16, 16, 16, 16, 16, 16, 16, 16, 16, 16, 16, 16, 16, 16, 16, 16, 16, 16
12, 12, 12, 12, 12,  5,  0,  2, 16, 16, 16, 16, 16, 16, 16,  2, 14,  0,  0,  0, 16, 16, 16, 16, 16, 16, 16, 16, 16, 16, 16, 16, 16, 16, 16, 16, 16, 16, 16, 16, 16, 16, 16, 16, 16, 16, 16, 16, 16, 16
12, 12, 12, 12, 12,  5,  0,  2,  5,  5,  5,  5,  5,  5,  5,  2, 14,  0,  0,  0, 16, 16, 16, 16, 16, 16, 16, 16, 16, 16, 16, 16, 16, 16, 16, 16, 16, 16, 16, 16, 16, 16, 16, 16, 16, 16, 16, 16, 16, 16
12, 12, 12, 12, 12,  5,  0,  2,  5,  5,  5,  5,  5,  5,  5,  5,  5,  5,  5,  5, 16, 16, 16, 16, 16, 16, 16, 16, 16, 16, 16, 16, 16, 16, 16, 16, 16, 16, 16, 16, 16, 16, 16, 16, 16, 16, 16, 16, 16, 16
12, 12, 12, 12, 12,  5,  0,  2,  5,  5,  5,  5,  5,  5,  5,  5,  5,  5,  5,  5,  5,  5,  5,  5,  5,  5,  5,  5,  5,  5,  5,  5,  5,  5,  5,  5,  5,  5,  5,  5,  5,  5,  5,  5,  5,  5,  5,  5,  5,  5
12, 12, 12, 12, 12,  5,  0,  2,  5,  5,  5,  5,  5,  5,  5,  5,  5,  5,  5,  5,  5,  5,  5,  5,  5,  5,  5,  5,  5,  5,  5,  5,  5,  5,  5,  5,  5,  5,  5,  5,  5,  5,  5,  5,  5,  5,  5,  5,  5,  5
12, 12, 12, 12, 12,  5,  0,  2,  5,  5,  5,  5,  5,  5,  5,  5,  5,  5,  5,  5,  5,  5,  5,  5,  5,  5,  5,  5,  5,  5,  5,  5,  5,  5,  5,  5,  5,  5,  5,  5,  5,  5,  5,  5,  5,  5,  5,  5,  5,  5
12, 12, 12, 12, 12,  5,  0,  2,  5,  5,  5,  5,  5,  5,  5,  5,  5,  5,  5,  5,  5,  5,  5,  5,  5,  5,  5,  5,  5,  5,  5,  5,  5,  5,  5,  5,  5,  5,  5,  5,  5,  5,  5,  5,  5,  5,  5,  5,  5,  5
12, 12, 12, 12, 12,  5,  0,  2,  5,  5,  5,  5,  5,  5,  5,  5,  5,  5,  5,  5,  5,  5,  5,  5,  5,  5,  5,  5,  5,  5,  5,  5,  5,  5,  5,  5,  5,  5,  5,  5,  5,  5,  5,  5,  5,  5,  5,  5,  5,  5
12, 12, 12, 12, 12,  5,  0,  2,  5,  5,  5,  5,  5,  5,  5,  5,  5,  5,  5,  5,  5,  5,  5,  5,  5,  5,  5,  5,  5,  5,  5,  5,  5,  5,  5,  5,  5,  5,  5,  5,  5,  5,  5,  5,  5,  5,  5,  5,  5,  5
12, 12, 12, 12, 12,  5,  0,  2,  5,  5,  5,  5,  5,  5,  5,  5,  5,  5,  5,  5,  5,  5,  5,  5,  5,  5,  5,  5,  5,  5,  5,  5,  5,  5,  5,  5,  5,  5,  5,  5,  5,  5,  5,  5,  5,  5,  5,  5,  5,  5
12, 12, 12, 12, 12,  5,  5,  5,  5,  5,  5,  5,  5,  5,  5,  5,  5,  5,  5,  5,  5,  5,  5,  5,  5,  5,  5,  5,  5,  5,  5,  5,  5,  5,  5,  5,  5,  5,  5,  5,  5,  5,  5,  5,  5,  5,  5,  5,  5,  5
12, 12, 12, 12, 12, 12, 12, 12, 12, 12, 12, 12, 12, 12, 12, 12, 12, 12, 12, 12, 12, 12, 12, 12, 12, 12, 12, 12, 12, 12,  5,  5,  5,  5,  5,  5,  5,  5,  5,  5,  5,  5,  5,  5,  5,  5,  5,  5,  5,  5
12, 12, 12, 12, 12, 12, 12, 12, 12, 12, 12, 12, 12, 12, 12, 12, 12, 12, 12, 12, 12, 12, 12, 12, 12, 12, 12, 12, 12, 12,  5,  5,  5,  5,  5,  5,  5,  5,  5,  5,  5,  5,  5,  5,  5,  5,  5,  5,  5,  5
12, 12, 12, 12, 12, 12, 12, 12, 12, 12, 12, 12, 12, 12, 12, 12, 12, 12, 12, 12, 12, 12, 12, 12, 12, 12, 12, 12, 12, 12,  5, 16, 16, 16, 16, 16, 16, 16, 16, 16, 16, 16, 16, 16, 16, 16, 16, 16, 16, 16
12, 12, 12, 12, 12, 12, 12, 12, 12, 12, 12, 12, 12, 12, 12, 12, 12, 12, 12, 12, 12, 12, 12, 12, 12, 12, 12, 12, 12, 12, 16, 16, 16, 16, 16, 16, 16, 16, 16, 16, 16, 16, 16, 16, 16, 16, 16, 16, 16, 16
12, 12, 12, 12, 12, 12, 12, 12, 12, 12, 12, 12, 12, 12, 12, 12, 12, 12, 12, 12, 12, 12, 12, 12, 12, 12, 12, 12, 12, 12, 16, 16, 16, 16, 16, 16, 16, 16, 16, 16, 16, 16, 16, 16, 16, 16, 16, 16, 16, 16
12, 12, 12, 12, 12, 12, 12, 12, 12, 12, 12, 12, 12, 12, 12, 12, 12, 12, 12, 12, 12, 12, 12, 12, 12, 12, 12, 12, 12, 12, 16, 16, 16, 16, 16, 16, 16, 16, 16, 16, 16, 16, 16, 16, 16, 16, 16, 16, 16, 16