12, 12, 12, 12, 12,  2,  0,  2,  5,  5,  5,  5,  5,  5,  5,  5,  5,  5,  5,  5
12, 12, 12, 12, 12,  2,  0,  2,  5,  5,  5,  5,  5,  5,  5,  5,  5,  5,  5,  5
12, 12, 12, 12, 12,  2,  0,  2,  5,  5,  5,  5,  5,  5,  5,  5,  5,  5,  5,  5
12, 12, 12, 12, 12,  2,  0,  2,  5,  5,  5,  5,  5,  5,  5,  5,  5,  5,  5,  5
12, 12, 12, 12, 12,  2,  0,  2,  5,  5,  5,  5,  5,  5,  5,  5,  5,  5,  5,  5
12, 12, 12, 12, 12,  2,  0,  2,  5,  5,  5,  5,  5,  5,  5,  5,  5,  5,  5,  5
12, 12, 12, 12, 12,  2,  0,  2,  5,  5,  5,  5,  5,  5,  5,  5,  5,  5,  5,  5
12, 12, 12, 12, 12,  2,  0,  2,  5,  5,  5,  5,  5,  5,  5,  5,  5,  5,  5,  5
12, 12, 12, 12, 12,  2,  0,  2,  5,  5,  5,  5,  5,  5,  5,  5,  5,  5,  5,  5
12, 12, 12, 12, 12,  2,  0,  2,  5,  5,  5,  5,  5,  5,  5,  5,  5,  5,  5,  5
12, 12, 12, 12, 12,  2,  0,  2,  5,  5,  5,  5,  5,  5,  5,  5,  5,  5,  5,  5
12, 12, 12, 12, 12,  2,  0,  2,  5,  5,  5,  5,  5,  5,  5,  5,  5,  0,  0,  2
12, 12, 12, 12, 12,  2,  0,  2,  5,  5,  5,  5,  5,  5,  5,  2,  0, 14,  0,  2
12, 12, 12, 12, 12,  2,  0,  2,  5,  5,  5,  5,  5,  5,  5,  2,  0, 14,  0,  2
12, 12, 12, 12, 12,  2,  0,  2,  5,  5,  5,  5,  5,  5,  5,  2,  0, 14, 14,  2
12, 12, 12, 12, 12,  2,  0,  2,  5,  5,  5,  5,  5,  5,  5,  2, 14, 14, 14,  2
12, 12, 12, 12, 12,  2,  0,  2,  5,  5,  5,  5,  5,  5,  5,  2, 14, 14, 14,  2
12, 12, 12, 12, 12,  2,  0,  2,  5,  5,  5,  5,  5,  5,  5,  2, 14, 14, 14,  2
12, 12, 12, 12, 12,  2,  0,  2,  5,  5,  5,  5,  5,  5,  5,  2, 14,  2, 14,  2
12, 12, 12, 12, 12,  2,  0,  2,  5,  5,  5,  5,  5,  5,  5,  2,  2,  2,  2,  2
12, 12, 12, 12, 12,  2,  0,  2,  4,  4,  4,  4,  4,  4,  4,  2,  0,  0,  0,  2
12, 12, 12, 12, 12,  2,  0,  2,  4,  4,  4,  4,  4,  4,  4,  4,  4,  4,  4,  4
12, 12, 12, 12, 12,  2,  0,  2,  4,  4,  4,  4,  4,  4,  4,  4,  4,  4,  4,  4
12, 12, 12, 12, 12,  2,  0,  2,  4,  4,  4,  4,  4,  4,  4,  4,  4,  4,  4,  4
12, 12, 12, 12, 12,  2,  0,  2,  4,  4,  4,  4,  4,  4,  4,  4,  4,  4,  4,  4
12, 12, 12, 12, 12,  2,  0,  2,  4,  4,  4,  4,  4,  4,  4,  4,  4,  4,  4,  4
12, 12, 12, 12, 12,  2,  0,  2,  4,  4,  4,  4,  4,  4,  4,  4,  4,  4,  4,  4
12, 12, 12, 12, 12,  2,  0,  2,  4,  4,  4,  4,  4,  4,  4,  4,  4,  4,  4,  4
12, 12, 12, 12, 12,  2,  0,  2,  4,  4,  4,  4,  4,  4,  4,  4,  4,  4,  4,  4
12, 12, 12, 12, 12,  2,  0,  2,  4,  4,  4,  4,  4,  4,  4,  4,  4,  4,  4,  4
12, 12, 12, 12, 12, 12, 12, 12, 12, 12, 12, 12, 12, 12, 12, 12, 12, 12, 12, 12
12, 12, 12, 12, 12, 12, 12, 12, 12, 12, 12, 12, 12, 12, 12, 12, 12, 12, 12, 12
12, 12, 12, 12, 12, 12, 12, 12, 12, 12, 12, 12, 12, 12, 12, 12, 12, 12, 12, 12
12, 12, 12, 12, 12, 12, 12, 12, 12, 12, 12, 12, 12, 12, 12, 12, 12, 12, 12, 12
12, 12, 12, 12, 12, 12, 12, 12, 12, 12, 12, 12, 12, 12, 12, 12, 12, 12, 12, 12
12, 12, 12, 12, 12, 12, 12, 12, 12, 12, 12, 12, 12, 12, 12, 12, 12, 12, 12, 12